Cannons - Fire for You (TiÃ«sto Remix)
Air Supply - All Out Of Love
88Rising - Midsummer Madness
2/14 - The Band Camino
Ge Qian - Jay Chou
1. Alan Walker
34+35 - Ariana Grande
Fools by Sacarstic sounds
Paramore , 26
Numb - Linkin Park
Stay - Justin Bieber, The Kid LAROI
Hurricane - Kanye West
Minority - Green Day
Avicii The Nights  
stand out fit in - one ok rock
read my mind - The killers
WITHOUT YOU - KID LAROI
Mildred / Patty Hill - Happy Birthday To You
TXT - Magic
Redemption by Pentakill
beside you - keshi
CORPSE - Cat Girls Are Ruining My Life!
CWG - Malik
Prologue by Minami
Empty Bed Saint Punk
(Current) Beast in Black - Beast in Black
Paint it Black - Rolling Stones
Lazy Song - Bruno Mars
Charlie by RHCP
the only exception - paramore
That's Why I Gave Up on Music - Yorushika
Pokemon - IDK
fav song: 2soon by keshi
Tomboy by Destiny Roger
Outside - Fiji Blue
Danger Zone - Kenny Loggins
Face Down - Arashi
we're still here - supercell
stay, justin beiber
Zhang Yun Jing - Pian Ai
LALISA - BLACKPINK
